####################################################################################################
#P#..R.#...#.S#....#....#...#......#.#..........#..........#.##...#.#..#.....#..##.....#.........#.#
#.#.##.#.#..#|..##..#.#.#.#.#.#.##....#.#####.#.#.###.##.#.#....#.#...#..#.#.##....#.#..#.##.#.##..#
#|..##...##.##.#..#.#.#.#.#...#...#|#..#....#..#.....#...#..#.###..#.#.#.#.#..#.#.#...#.#..#.#....##
 ###SS#|#.#..#.#.#..|.##...###.##...##..#.#.##.|#.##..#.#.#...#..#.#.#...#..#.#..#..#.#.#.##..###..#
#....##...#.#S.#|#|##.....#...#...##...#...#..#.SS.S###..#..###.#.#.#...##..#...###.#.#..#...#....##
#.##....#.#...#..#.#.####..#..#.#..#.# ###.#.##.#.#....#..#......#..#.#...#.#.#....#.#.#.##..##.#..#
#..##.#..#.###.#...#.#...## #...##.R.S#....#...#..#.###.#..#.##.#.#.##..##..#...##.#...#...#..#..###
#...#.#.#..#.....##.#..#...#..##...#.#S.##..##.#.##...#..#.#.#....#....#.##..#.#..#..##..#.##..#...#
#..#...#..##.####.....# ##.##..#.## #..##R#.#..#...##..#...#..#.#..####.....#.#..##.#  #.#..##..##.#
#.#..##..#...#...##.#..#.#...#.#...#..#...#..#..##.#.#.#.#...##..##....###.#....##..# #..##..#.#.#.#
#..#.#..#..###.#....##.#.###..#..#.#.#..#..#.#.#.#...#..#..#...#....##......##.#...#.#..#.##.#...#.#
#.##...#..#....###.#...#...##.#.#..#.#.#.#...#.#..#.# #.#.#..#..#####.#.###..#...###...#.....##.#..#
####################################################################################################