################################
#P.R...R..#.S.......R#.........#
#R...R....#.....S....#....R.R..#
##|#########|#########.........#
#.....#..............#.....R...#
#.....#S..........R..#.........#
#.R...#..S........RR.#...R.....#
#.....|.....S........#.........#
#.....################.........#
#....S...R.....R.....######|####
#............R.......|.....S...#
#....................###########
#....................#......S..########
#....................|R..S.........|R.#
#....................#.R..R....########
################################