##################################
#P...............................#
##|###############################
#................................#
#................................#
#..........S.....................#
#................................#
#................................#
#................................#
######|###########################
######|##############################################################
#............#............#..S..S..............|.#................S.#
#............#......R.....#...R................#.######|#############
#............|.....S......#....................#.|.........R.....RR.#
#............#............#....................#.#............R.....#
######|#########################################|####################
#...................................................................#
#...................................................................#
#...................................................................#
#...................................................................#
#...................................................................#
#...................................................................#
#...................................................................#
#...................................................................#
#####################################################################